PPPPPPPPPP
PCCCCCPPPP
PPCPPCCCPP
PPCCCCPCPP
PPPPPCPCPP
PPCCCCPCPP
PPCPPCPCPP
PPPPPCCCPP
PPPPPCPPPP
PPPPPSPPPP
