PPPPPPPPPPPPPPPPPPPP
PCCCCCCCCCCCCCCCCCCP
PPPPPCPPPPPPPCPPPPCP
PCCCCCPPPPPPCCPPPPCP
PCPPPPPCCCCCCPPPPPCP
PPPPPPPCPPPPPPCCCCCP
PCPCCCCCPPPPPPCPPPCP
PCPCPPPPPPPPCCCPPPCP
PCPCPPPCPPPPCPPPPPCP
PCPCPPPCCCCCCPPPPPPP
PCPCPPPPPPPPCCCCCPPP
PCCCPPCCCPPPCPPPCPCP
PPPCPPPPCCCCCPPPCPCP
PPPCPPPPPPPPPPPPCPCP
PPPCCCCCCCPPPCPPCPCP
PPPCPPPPPCPPCCCCCCCP
PPPCPCPPPCPPCPPPCPPP
PPPCPCCCCCPPCPPPCPPP
PCCCPCPPPCCCCPPPCPPP
PPPPPPPPPPPPPPPPSPPP
