PPPPPPPPPP
PCCCCCPPPP
PPCPPCCCPP
PPCCCCPPPP
PPPPPCPPPP
PPCCCCPPPP
PPCPPCPPPP
PPPPPCPPPP
PPPPPCPPPP
PPPPPSPPPP
