PSPPPPPPPPPPPPPPPPPP
PCPPPCPCCCPCPCPCCCPP
PCCCCCPCPCPCCCCCPCPP
PPPPPCPCPPPCPPCPPCCP
PCCCPCPCPPPCPPCPPCPP
PCCCPCCCCCCCCCCCCCPP
PCCCPCPPPPPCPPPPPCPP
PCPPPCCCCPCCPCCCPCPP                
PCCCCCPPCPCPPCPCPCPP
PCCPPPPPCPCCCCPCPCCP
PPCCPCPPCPPPPPPCPPCP
PCCCPCPPCCCCCCCCPCCP
PPPCCCCPPCPPCPPPPCPP
PPCCPPCPPCCCCPPPPCPP
PPPCPCCCCPCCCCCPPCPP
PCCCPPPCCPCPCPPPPCPP
PPCCPPPPCCCPPPPPPCPP
PCCCPPCCCPCPPCCCCCCP
PCPCCCCCCCCCCCPPCCCP
PPPPPPPPPPPPPPPPPPPP